{
	"map": [
		"1111111455",
		"1111115455",
		"5111155455",
		"5555555455",
		"5555554555",
		"5555554415",
		"3223234411",
		"5555554411",
		"5551554411",
		"5551155444"
	],
	"objs": []
}